NO ./textures/Blue_Nebula_03-1024x1024.xpm
SO ./textures/Blue_Nebula_03-1024x1024.xpm
WE ./textures/Blue_Nebula_03-1024x1024.xpm
EA ./textures/Blue_Nebula_03-1024x1024.xpm
F 20,20,20
C 165,229,255

11111111111111111111111111111111 111
100000000000000N0000000000000001 101
11111111111111111111111111111111 111

