NO ./textures/blue_wallpaper.xpm
SO ./textures/yellow_wallpaper.xpm
WE ./textures/green_wallpaper.xpm
EA ./textures/red_wallpaper.xpm
F 128,171,111
C 165,229,255

           1
     111111011111
     1000000000001
     100111111111
     1001
 111 1001
1101100011111111
10N00000000000001
1101111110001111
 111    11011
        11011
        11011
        10001
       1000001
       1000001
        11111