F 20,20,20
C 165,229,255

EA ./textures/Blue_Nebula_03-1024x1024.xpm
WE ./textures/Blue_Nebula_03-1024x1024.xpm
SO ./textures/Blue_Nebula_03-1024x1024.xpm
NO ./textures/Blue_Nebula_03-1024x1024.xpm


                1
     11111111111011111
     100000000000000001
     10011111111111111
     1001
 111 1001
1101100011111111
10N000000000000011
1101111110001111
 111    10001
        11011
        11011
11111111111111111111
11111111
101
111111111111111111
