F 20,20,20
C 165,229,255

EA ./textures/Blue_Nebula_03-1024x1024.xpm
WE ./textures/Blue_Nebula_03-1024x1024.xpm
SO ./textures/Blue_Nebula_03-1024x1024.xpm
NO ./textures/Blue_Nebula_03-1024x1024.xpm


 111111111111111111111111111111111111111111111111111111111111111111111111111111111111111
1000000000000000000000000000000000000000000000N000000000000000000000000000000000000000001
 111111111111111111111111111111111111111111111111111111111111111111111111111111111111111
