NO ./textures/Blue_Nebula_03-1024x1024.xpm
SO ./textures/Blue_Nebula_03-1024x1024.xpm
WE ./textures/Blue_Nebula_03-1024x1024.xpm
EA ./textures/Blue_Nebula_03-1024x1024.xpm
F 128,171,111
C 165,229,255

 111111111111111111111111111111111
10000000000000000000000000000000001
10000000000000000000000000000000001
10000000000000000000000000000000001
10000000000000000000000000000000001
10000000000000011100000000000000001
10000000000000011100000000000000001
10000000000000011100000000000000001
10000000000000000000000000000000001
10000000000000000000000000000000001
10000000000000000N00000000000000001
10000000000000000000000000000000001
10000000000000000000000000000000001
10000000000000000000000000000000001
10000000000000000000000000000000001
10000000000000000000000000000000001
10000000000000000000000000000000001
10000000000000000000000000000000001
10000000000000000000000000000000001
10000000000000000000000000000000001
10000000000000000000000000000000001
 111111111111111111111111111111111
