EA ./textures/Blue_Nebula_03-1024x1024.xpm
WE ./textures/Blue_Nebula_03-1024x1024.xpm
SO ./textures/Blue_Nebula_03-1024x1024.xpm
NO ./textures/Blue_Nebula_03-1024x1024.xpm
F 20,20,20
C 165,229,255
               111
     111111111110111111
     100000000000000001
     100111111111111111
     1001
 111 1001
11011100111111111
10N000000000000011
11011111100011111
 111    10001
        11011
        11011
1111111111111111111111
1111110000001010101010101010
