EA ./textures/Blue_Nebula_03-1024x1024.xpm
WE ./textures/Blue_Nebula_03-1024x1024.xpm
SO ./textures/Blue_Nebula_03-1024x1024.xpm
NO ./textures/Blue_Nebula_03-1024x1024.xpm
F 20,20,20
C 165,229,255

11111
10N01
11111