EA ./textures/Blue_Nebula_03-1024x1024.xpm
WE ./textures/Blue_Nebula_03-1024x1024.xpm
SO ./textures/Blue_Nebula_03-1024x1024.xpm
NO ./textures/Blue_Nebula_03-1024x1024.xpm
F 20,20,20
C 165,229,255
               111
     1111111111101111
     1000000000001000
     1001111111111
     1001
 111 1001
11011100111111111
10N000000000000011
11011111100011111
 111    10001
        11011
        11111
