NO ./textures/Blue_Nebula_03-1024x1024.xpm
SO ./textures/Blue_Nebula_03-1024x1024.xpm
WE ./textures/Blue_Nebula_03-1024x1024.xpm
EA ./textures/Blue_Nebula_03-1024x1024.xpm

F 20,20,20

C 165,229,255


111111
100101
1010001111
1100N00001
1111110001
0000011111



