------------------------start-------------


 1
101
101
101
101
101
101
101
101
101
101
101
101
101
1S1
101
101
101
101
101
101
101
101
101
101
101
101
101
101
101
 1


------------------------end-------------


------------------------start-------------


 111111111111111111111111111111111111111111111111111111111111111111111111111111111111111
1000000000000000000000000000000000000000000000N000000000000000000000000000000000000000001
 111111111111111111111111111111111111111111111111111111111111111111111111111111111111111


------------------------end-------------

------------------------start-------------


                1
     11111111111011111
     100000000000000001
     10011111111111111
     1001
 111 1001
1101100011111111
10N000000000000011
1101111110001111
 111    10001
        11011
        11011
11111111111111111111
11111111
101
111111111111111111


------------------------end-------------

------------------------start-------------


 1
101
101
101
101
101
101
101
101
101
101
101
101
101
101
101
101
101
101
101
101
101
101
101
101
101
101
101
101
1011111111111111111111111111111111111111111111111111111111111111111111111111111111111111
1000000000000000000000000000000000000000000000N000000000000000000000000000000000000000001
1111111111111111111111111111111111111111111111111111111111111111111111111111111111111111


------------------------end-------------
