NO ./textures/METALTILE.xpm
SO ./textures/METALTILE.xpm
WE ./textures/STORAGE.xpm
EA ./textures/STORAGE.xpm
C 40,40,50
F 100,100,120

  11
 1001
 10011111
 10000101111                 111111111  
 10000100001111          1111100000001
 1000010110100111111111111000000000001
 1000010000100000000000000000000000001
 1000000000100000011100000001111110001
 1000000000000000000000001111    10001
 10000000001000000111111011      10001
 10000N00101111011100000001      10011
 11000000000010000000000001      1001
 11011111111110001000111111      1001
  101        10001011            1001
  101        1001101             1001
  101        1000101             1001
  101        1000101             1001
 11011111    1000101      11111110001
 10000001111 1000101      10000000001
 100000000001100000111111110000011111
 10000000000000000000000000000001
 11111101111111000000000000000001
      101     1011111111111100001
 111111011111 101          100001
 100000000001 101          100001
 100000000001 101          100001
 100000110001 101          100001
  10000110001 101          100001
  10000000001 101          100001
  10000000001 101          100001
   1111000001110111111111111000011
       1000000000000000000000000001
       1000000010000000100000000001
        11111111111111111111111111