NO ./textures/METALTILE.xpm
SO ./textures/METALTILE.xpm
WE ./textures/STORAGE.xpm
EA ./textures/STORAGE.xpm
C 40,40,50
F 100,100,120

11111111111
10000000001
10000000001
10000N00001
10000000001
11111111111