NO ./textures/0000.dummy/red_wallpaper.xpm
SO ./textures/0000.dummy/blue_wallpaper.xpm
WE ./textures/0000.dummy/green_wallpaper.xpm
EA ./textures/0000.dummy/yellow_wallpaper.xpm
F 128,171,111
C 165,229,255

111111111111111111111
100000000000000000001
101010101010101010101
100000000000000000001
101010101010101010101
1000000000N0000000001
101010101010101010101
100000000000000000001
111111111111111111111